0  0  0  0  0  0  0  0  0  0  0  0  0  0  0  0  0  0  0  0  0  0  0  0  0  0  0  0  0  0  0  0  0  0  0  0  0  0  0  0  0  0  0  0  0  0  0  0  0  0  0  0  0  0  0  0  0  0  0  0
0  0  0  0  0  0  0  0  0  0  0  0  0  0  0  0  0  0  0  0  0  0  0  0  0  0  0  0  0  0  0  0  0  0  0  0  0  0  0  0  0  0  0  0  0  0  0  0  0  0  0  0  0  0  0  0  0  0  0  0
0  0  0  0  0  0  0  0  0  0  0  0  0  0  0  0  0  0  0  0  0  0  0  0  0  0  0  0  0  0  0  0  0  0  0  0  0  0  0  0  0  0  0  0  0  0  0  0  0  0  0  0  0  0  0  0  0  0  0  0
0  0  0  0  0  0  0 22  7  7  7  7  7  7  7  7  7  7  7  7  7  7  7 23  0  0  0  0  0  0  0  0  0  0  0  0  0  0  0  0  0  0 22  7  7  7  7  7  7  7  7  7 23  0  0  0  0  0  0  0
0  0  0  0  0  0  0  5 17 16 16 16 16 16 16 16 16 16 16 16 16 16 15  6  0  0  0  0  0  0  0  0  0  0  0  0  0  0  0  0  0  0  5 17 16 16 16 16 16 16 16 15  6  0  0  0  0  0  0  0
0  0  0  0  0  0  0  5 14 13 13 13 13 13 13 13 13 13 13 13 13 13 12  6  0  0  0  0  0  0  0  0  0  0  0  0  0  0  0  0  0  0  5 14 13 13 13 13 13 13 13 12  6  0  0  0  0  0  0  0
0  0  0  0  0  0  0  5  0  0 10 10 10 10 10 10 10 10 10 10 10 10  9  6  0  0  0  0  0  0  0  0  0  0  0  0  0  0  0  0  0  0  5 11 10 10 10 10 10 10 10  9  6  0  0  0  0  0  0  0
0  0  0  0  0  0  0  5 21 20 21 20 21 20 21 20 21 20 21 20 21 20 21  1  7  7 23  0  0  0  0  0  0  0  0  0  0  0  0  0  0  0  5 20 21 20 21 20 21 20 21 20  6  0  0  0  0  0  0  0
0  0  0  0  0  0  0  5 20 21 20 21 20 21 20 21 20 21 20 21 20 21 20 17 16 15  6  0  0  0  0  0  0  0  0  0  0  0  0  0  0  0  5 21 20 21 20 21 20 21 20 21  6  0  0  0  0  0  0  0
0  0  0  0  0  0  0  5 21 20 21 20 21 20 21 20 21 20 21 20 21 20 21 14 13 12  6  0  0  0  0  0  0  0  0  0  0  0  0  0  0  0  5 20 21 20 21 20 21 20 21 20  6  0  0  0  0  0  0  0
0  0  0  0  0  0  0  5 20  8  8 21 20 21 20 21 20 21 20 21 20 21 20 11 10  9  6  0  0  0  0  0  0  0  0  0  0  0  0  0  0  0  5 21 20 21 20 21 20 21 20 21  6  0  0  0  0  0  0  0
0  0  0  0  0  0  0  5 21  8  8 20 21 20 21 20 21 20 21 20 21 20 21 20 21 20  1  7  7  7  7  7  7  7  7  7  7  7  7  7  7  7  2 20 21 20 21 20 21 20 21 20  6  0  0  0  0  0  0  0
0  0  0  0  0  0  0  5 20  8  8 21 20 21 20 21 20 21 20 21 20 21 20 21 20 21 17 16 16 16 16 16 16 16 16 16 16 16 16 16 16 16 15 21 20 21 20 21 20 21 20 21  6  0  0  0  0  0  0  0
0  0  0  0  0  0  0 24  8  8  8  8  8  8  8  8  8  8  4 20 21 20 21 20 21 20 14 13 13 13 13 13 13 13 13 13 13 13 13 13 13 13 12 20 21 20 21 20 21 20 21 20  6  0  0  0  0  0  0  0
0  0  0  0  0  0  0  0  0  0  0  0  0  0  0  0  0  0  5 21 20 21 20 21 20 21 11 10 10 10 10 10 10 10 10 10 10 10 10 10 10 10  9 21 20 21 20 21 20 21 20 21  6  0  0  0  0  0  0  0
0  0  0  0  0  0  0  0  0  0  0  0  0  0  0  0  0  0  5 20 21 20 21 20 21 20 21 20 21 20 21 20 21 20 21 20 21 20 21 20 21 20 21 20 21 20 21 20 21 20 21 20  6  0  0  0  0  0  0  0
0  0  0  0  0  0  0  0  0  0  0  0  0  0  0  0  0  0  5 21 20 21 20 21 20 21 20 21 20 21 20 21 20 21 20 21 20 21 20 21 20 21 20 21 20 21 20 21 20 21 20 21  6  0  0  0  0  0  0  0
0  0  0  0  0  0  0  0  0  0  0  0  0  0  0  0  0  0  5 20 21 20 21 20 21 20 21 20 21 20 21 20 21 20 21 20 21 20 21 20 21 20 21 20 21 20 21 20 21 20 21 20  6  0  0  0  0  0  0  0
0  0  0  0  0  0  0  0  0  0  0  0  0  0  0  0  0  0  5 21 20 21 20 21 20 21 20 21 20 21 20 21 20 21 20 21 20 21 20 21 20 21 20 21 20 21 20 21 20 21 20 21  6  0  0  0  0  0  0  0
0  0  0  0  0  0  0  0  0  0  0  0  0  0  0  0  0  0  5 20 21 20 21 20 21 20 21 20 21 20 21 20 21 20 21 20 21 20 21 20 21 20 21 20 21 20 21 20 21 20 21 20  6  0  0  0  0  0  0  0
0  0  0  0  0  0  0  0  0  0  0  0  0  0  0  0  0  0  5 21 20 21 20 21 20 21 20 21 20 21 20 21 20 21 20 21 20 21 20 21 20 21 20 21 20 21 20 21 20 21 20 21  6  0  0  0  0  0  0  0
0  0  0  0  0  0  0  0  0  0  0  0  0  0  0  0  0  0  5 20 21 20 21 20 21 20 21 20 21 20 21 20 21 20 21 20 21 20 21 20 21 20 21 20 21 20 21 20 21 20 21 20  6  0  0  0  0  0  0  0
0  0  0  0  0  0  0  0  0  0  0  0  0  0  0  0  0  0  5 21 20 21 20 21 20 21 20 21 20 21 20 21 20 21 20 21 20 21 20 21 20 21 20 21 20 21 20 21 20 21 20 21  6  0  0  0  0  0  0  0
0  0  0  0  0  0  0  0  0  0  0  0  0  0  0  0  0  0  5 20 21 20 21 20 21 20 21 20 21 20 21 20 21 20 21 20 21 20 21 20 21 20 21 20 21 20 21 20 21 20 21 20  6  0  0  0  0  0  0  0
0  0  0  0  0  0  0  0  0  0  0  0  0  0  0  0  0  0  5 21 20 21 20 21 20 21 20 21 20 21 20 21 20 21 20 21 20 21 20 21 20 21 20 21 20  3  8  8  8  8  8  8 25  0  0  0  0  0  0  0
0  0  0  0  0  0  0  0  0  0  0  0  0  0  0  0  0  0  5 20 21 20 21 20 21 20 21 20 21 20 21 20 21 20 21 20 21 20 21 20 21 20 21 20 21  6  0  0  0  0  0  0  0  0  0  0  0  0  0  0
0  0  0  0  0  0  0  0  0  0  0  0  0  0  0  0  0  0  5 21 20 21 20 21 20 21 20 21 20 21 20 21 20 21 20 21 20 21 20 21 20 21 20 21 20  6  0  0  0  0  0  0  0  0  0  0  0  0  0  0
0  0  0  0  0  0  0  0  0  0  0  0  0  0  0  0  0  0  5 20 21 20 21 20 21 20 21 20 21 20 21 20 21 20 21 20 21 20 21 20 21 20 21 20 21  6  0  0  0  0  0  0  0  0  0  0  0  0  0  0
0  0  0  0  0  0  0  0  0  0  0  0  0  0  0  0  0  0 24  8  8  8  8  8  8  8  8  8  8  8  8  8  8  8  8  8  8  8  8  8  8  8  8  8  8 25  0  0  0  0  0  0  0  0  0  0  0  0  0  0
0  0  0  0  0  0  0  0  0  0  0  0  0  0  0  0  0  0  0  0  0  0  0  0  0  0  0  0  0  0  0  0  0  0  0  0  0  0  0  0  0  0  0  0  0  0  0  0  0  0  0  0  0  0  0  0  0  0  0  0
0  0  0  0  0  0  0  0  0  0  0  0  0  0  0  0  0  0  0  0  0  0  0  0  0  0  0  0  0  0  0  0  0  0  0  0  0  0  0  0  0  0  0  0  0  0  0  0  0  0  0  0  0  0  0  0  0  0  0  0
0  0  0  0  0  0  0  0  0  0  0  0  0  0  0  0  0  0  0  0  0  0  0  0  0  0  0  0  0  0  0  0  0  0  0  0  0  0  0  0  0  0  0  0  0  0  0  0  0  0  0  0  0  0  0  0  0  0  0  0
